aa	/
ee	/
ii	/
oo	/
uu	/
vv	/
b	b
c	c
ch	ch
d	d
f	f
g	g
h	h
j	j
k	k
l	l
m	m
n	n
p	p
q	q
r	r
s	s
sh	sh
t	t
x	x
z	z
zh	zh
a	a
ai	a	i
an	a	n
ang	a	ng
ao	a	o
e	e
ei	e	i
en	e	n
eng	e	ng
er	er
i	i
ia	i	a
ian	i	a	n
iang	i	a	ng
iao	i	a	o
ie	i	ee
in	i	n
ing	i	ng
iong	i	o	ng
iu	i	o	u
ix	ih
iy	iz
iz	ih
o	o
ong	o	ng
ou	o	u
u	u
ua	u	a
uai	u	a 	i
uan	u	a	n
uang	u	a 	ng
ueng	u	e	ng
ui	u	e	i
un	u	e	n
uo	u	o
v	v
van	v	a	n
ve	v	ee
vn	u	n